Was bezeichnen folgende Angaben genau?<br>kB / MB / GB<br>kiB / MiB / GiB<br>kb / Mb / Gb<br>kib / Mib / Gib	"SI-Einheiten gelten auch für die IT - theoretisch also<div><ul><li>k&nbsp;≙ 10<sup>3</sup>,&nbsp;ki&nbsp;≙ 2<sup>10</sup><br></li><li>M<sup>&nbsp;</sup>≙ 10<sup>6</sup><span style=""font-size: 16.6667px;"">, </span>Mi<span style=""font-size: 16.6667px;"">&nbsp;</span>≙ 2<sup>20</sup><br></li><li>G&nbsp;≙ 10<sup>9</sup>, Gi&nbsp;≙ 2<sup>30</sup></li></ul></div><div>Praktisch sind k / M / G allerdings eher unspezifisch.</div><div><br></div><div>Ein großes B bezeichnet ein Byte, ein kleines b ein Bit.</div>"
Wofür steht USV und wofür dient es?	Unterbrechungsfreie Stromversorgung:&nbsp;<div><ul><li>Ausgleich von Netzschwankungen<br></li><li>Geordnetes Herunterfahren wichtiger Komponenten bei Netzwerkausfällen<br></li><li>Beobachtung des Stromnetzverhaltens mit Benachrichtigung<br></li></ul></div>
Wofür steht KVM und was ist eine KVM-Konsole?	Keyboard, Video, Mouse - als Konsole eine möglichst kompakte Bedieneinheit mit Ein- und Ausgabegeräten zum Einbau in Serverschränken
Welche Topologie hat der PCI-Bus?	Bustopologie
Wofür steht PCI und wozu dient es?	Peripheral Component Interconnect - Verbindung von Erweiterungs-Steckkarten
Welche Topologie hat der PCIe-Bus?	Sterntopologie zwischen den einzelnen Karten und einem Switch auf dem Mainboard
Welche Bitbreite und Takt- und Übertragungsrate hat der PCI-Bus?	<div><ul><li>32bit bei bis zu 66 MHz und 266 MBps<br></li><li>64bit bei bis zu 66 MHz und 533 MBps<br></li></ul></div>
Welche Bitbreite und Takt- und Übertragungsrate hat der PCIe-Bus?	<ul><li>64 bit Übertragungsbreite<br></li><li>Eine Taktrate gibt es nicht mehr, nur noch einen Referenztakt<br></li><li>Bis zu 32 Gbd (Gibabaud) werden durch eine PCIe5.0-Lane erreicht<br></li><li>Durch 128b/130b-Fehlerkorrektur resultieren knapp 4 GByte / s / Lane<br></li></ul>
Wofür steht USB und wozu dient er?	Universal Serial Bus - universeller, hotplugfähiger Anschluss für Plug&amp;Play-Peripheriegeräte
Welche Nettodatenraten erreichen aktuelle USB-Standards maximal?	<ul><li>USB 2.0: 36 MBps<br></li><li>USB 3.0: 400 MBps<br></li><li>USB 3.1: 800 MBps<br></li></ul>
Welche Zusatzfunktionen hat USB-C gegenüber älteren Verbinderstandards?	<ul><li>Orientierungsunabhängig<br></li><li>Höhere Ströme durch Power-Delivery-Aushandlung<br></li><li>Authentifizierung für signierte Firmware<br></li></ul>
Welche maximalen Kabellängen sind bei USB zu beachten?	<ul><li>USB 2.0: 5m<br></li><li>USB 3.0/1: 3m<br></li></ul>
Welche Übertragungsraten bietet Firewire?	400 (Basis), 800 oder 3200 Mbps
Was ist der größte Vorteil von Firewire gegeüber USB?	Daisy Chaining - Aneinanderstecken von bis zu 16 4,5m-Kabeln für bis zu 72m Reichweite
Welche Datenübertragungsrate bietet Thunderbolt?	<ul><li>Thunderbolt 1.0: 10 Gbps<br></li><li>Thunderbolt 2.0: 20 Gbps<br></li><li>Thunderbolt 3.0: 40 Gbps<br></li></ul>
Wofür steht TPM und wofür dient es?	Trusted Platform Module - Signierung von Systemsoftware
Für was steht die Abkürzung IEEE?	Institute of Electrical and Electronic Engineers
Für was steht die Abkürzung ISO?	ISO ist keine Abkürzung, bezeichnet aber die International Organization for Standardization
Für was steht OSI?	Open Systems Interconnection
Für was steht DIN?	"Deutsches Institut für Normung -&nbsp;<b>nicht </b>""Deutsche Industrienorm""!"
Was ist der Hauptunterschied zwischen einem Supercomputer und einem Mainframe?	<ul><li>Supercomputer: Erreichung maximaler Leistung<br></li><li>Mainframe: Erreichung maximaler Zuverlässigkeit<br></li></ul>
Was sind Beispiele für Mainframe-Betriebssysteme?	<ul><li>z/OS<br></li><li>Unicos<br></li><li>OS/360<br></li><li>BS2000<br></li></ul>
Was ist ein Bladeserver?	Ein modular horizontal skalierbarer Lastverbund aus Recheneinheiten, die sich eine gemeinsame Stromversorgung und Speichermedien teilen
Was ist horizontale Skalierung?	Die Verteilung von Aufgaben oder Inhalten auf mehrere Systeme im Verbund
Was ist vertikale Skalierung?	Die Zuteilung von Ressourcen zu einem bestehenden System
Aus welchen Teilen besteht ein Betriebssystem mit monolithischem Kern?	Kernel<div>Anwendungen</div>
Welche Komponenten hat ein monolithischer Kernel?	Von oben nach unten - Zugriffsrecht in dieser Richtung:<div><ul><li>Dateisysteme<br></li><li>Geräteverwaltung</li><li>Prozessverwaltung<br></li><li>Speicherverwaltung<br></li><li>Hardwareschnittstelle</li></ul></div>
Was charakterisiert einen monolithischen Kernel?	Sämtliche Kernelfunktionen sind direkt im Kernel integriert und werden im Kernel Mode betrieben
Was charakterisiert einen Microkernel?	Der Kernel enthält nur die absoluten Grundfunktionen (Speicher- und Prozessverwaltung und Sicherungsmechanismen), der Rest ist in User-Mode-Programme ausgelagert
Was charakterisiert einen Hybridkernel?	Nicht alle Funktionen eines monolithischen Kernels sind enthalten, nicht alle Funktionen sind wie beim Microkernel ausgelagert
Was ist der User Mode in Bezug auf die Prozessprivilegierung im x86-Betriebssystem?	Programme im CPU-Ring 3 laufen mit eingeschränkten Rechten - einige Funktionen des Befehlssatzes sind nicht zugänglich
Was ist der Kernel Mode in&nbsp;Bezug auf die Prozessprivilegierung im x86-Betriebssystem?	Programme im Ring 0 laufen mit uneingeschränkten Rechten - sie haben Zugriff auf den vollen Befehlssatz der CPU
In welchem Ring der x86-Architektur läuft ein Typ-1-Hypervisor und in welchem seine Clients?	<ul><li>Ursprünglich: Hypervisor in Ring 0, Clients in Ring 1<br></li><li>Neuere CPUs: Neuer Ring -1 für Hypervisor, Clients in Ring 0<br></li></ul>
Wie viele Ringe hat die herkömmliche x86-Architektur und wie viele davon werden üblicherweise genutzt?	<ul><li>4 insgesamt<br></li><li>Genutzt meist nur 0 und 3 (Kernel Mode und User Mode)<br></li></ul>
Welche Aufgaben hat der Kernel eines Betriebssystems?	<ul><li>Schnittstelle für Endanwenderprogramme<br></li><li>Ressourcenverwaltung und -verteilung<br></li><li>Zugriffskontrolle mit Locks und Queues<br></li><li>Virtualisierung von Ressourcen<br></li><li>Rechteverwaltung in Mehrbenutzersystemen<br></li></ul>
Welche Arten von Treibern gibt es in Bezug auf ihre Privilegierung?	<ul><li>Kernel-Mode-Treiber - direkt im Kernel integriert oder als Modul nachgeladen<br></li><li>User-Mode-Treiber - Dienstprogramm mit indirektem Hardwarezugriff über Kernelschnittstellen<br></li></ul>
Was ist ein Embedded-Betriebssystem?	Ein auf seine minimalen Funktionen reduziertes, spezialisiertes Betriebssystem
Wofür steht LDAP und was ist ein LDAP-Server?	Lightweight Directory Access Protocol - hierarchische Datenbank als Verzeichnisdienst, mit der Objekte in Gruppen gegliedert und mit Attributen versehen werden können
Wofür steht CIFS und was ist es?	Common Internet File System - eine Implementation des Server Message Block (SMB) von Microsoft für Netzwerkzugriff auf Dateien und Ressourcen
Wofür steht DNS und wozu dient es?	Domain Name System dient für<div><ul><li>Namensauflösung in IP und zurück (PTR, A)</li><li>Definition von Diensten für Autodiscovery (MX, SRV)</li><li>Publikation von Policies (TXT)<br></li><li>White- und Blacklisting (DNSBL)</li></ul></div>
Was ist UNIX?	Eine mehrbenutzer-, mehrprozess- und netzwerkfähige Betriebssystemfamilie basierend auf einem System von AT&amp;T
Welches ist die derzeit verbreitetste UNIX-Implementation?	Apple OSX / macOS
Was bezeichnet man als *NIX-Systeme?	Unixartige Systeme, die nicht als solches zertifiziert / zertifizierbar sind (z. B. Linux)
Welches sind die bekanntesten UNIX-Distributionen?	<ul><li>System V (ursprüngliches UNIX)<br></li><li>HP-UX<br></li><li>Solaris<br></li><li>BSD<br></li><li>AIX<br></li></ul><div>Als Clientsystem außerdem OSX / macOS.</div>
Was charakterisiert Open-Source-Software?	<ul><li>Vorliegen des Quelltexts in menschenlesbarer Form<br></li><li>Beliebieges Kopieren, Verbreiten und Nutzen des Programms<br></li><li>Beliebiges Verändern des Programms und Weitergabe in veränderter Form<br></li></ul><div>Open-Source-Software kann über ihre Lizenz diese Freiheiten an Bedingungen knüpfen.</div>
Was charakterisiert Public-Domain-Software?	<ul><li>Vorliegen des Quelltexts<br></li><li>Völlige und uneingeschränkte Freiheit beim Umgang mit dem Programm und seinem Quellcode<br></li></ul>
Was charakterisiert Freeware-Programme?	Freie Zugänglichkeit eines meist fertig kompilierten Programms unter den Bedingungen der vom Autor verwendeten Endbenutzerlizenz
Was charakterisiert Shareware-Programme?	<ul><li>Freie Zugänglichkeit des Programms für eine begrenzte Zeit oder in einem begrenzten Umfang<br></li><li>Freie Weiterverteilung des Programms als Werbung<br></li></ul>
Was bedeutet Copyleft im Kontext der Software-Lizenzierung?	Dass ein abgeleitetes Werk die gleiche Lizenz wie das Ursprungswerk erhalten muss
Wofür steht GNU und was ist es?	GNU's Not UNIX - Freies Mikrokernel-Betriebssystem, dessen User-Mode-Anwendungen in Kombination mit Linux weit verbreitet sind
Wofür steht GPL und worum handelt es sich?	GNU General Public License, die Basis der am Weitesten verbreiteten Lizenzen für freie und Open-Source-Software
Welches sind die bedeutendsten Linux-Distributionen auf Serversystemen?	<ul><li>Red Hat Enterprise Linux (RHEL)&nbsp; / CentOS<br></li><li>Debian<br></li><li>OpenSUSE</li><li>Ubuntu Server</li></ul>
Was ist eine Distribution im Kontext von *NIX-Systemen?	Eine bestimmte Ausprägung der Betriebssystemfamilie mit einem eigenen Entwicklerteam, die nur eingeschränkt mit anderen Distributionen kompatibel ist
Was ist das X Window System?	Der Serverdienst, der unter *NIX-Systemen üblicherweise Schnittstellen für die grafische Oberfläche bereitstellt
Was beschreibt der Begriff Containervirtualisierung?	<ul><li>Virtualisierung auf Betriebssystemebene statt mit vollwertigem Hypervisor<br></li><li>Gemeinsame Nutzung wenigstens des Kernels<br></li><li>Abspaltung bestimmter Ressourcen in getrennte Bereiche je Container<br></li></ul>
Was charakterisiert vollständige Virtualisierung von Betriebssystemen?	Bereitstellung kompletter Betriebssysteme inklusive Kernel
Welche besonderen Anforderungen werden an Serverhardware gestellt?	<ul><li>Zuverlässigkeit<br></li><li>Integrität gespeicherter und Laufzeitdaten<br></li><li>Leistungsfähigkeit<br></li><li>Skalierbarkeit<br></li></ul>
Welche zwei Aspekte gibt es bei der Herstellung von Hochverfügbarkeit?	<ul><li>Redundanz im System<br></li><li>Redundanz der Systeme<br></li></ul>
Welche Möglichkeiten gibt es für die Herstellung von Ausfallsicherheit im System?	<ul><li>Mehrfache Auslegung von Stomversogung, Lüftung etc.<br></li><li>RAID-Verbünde für Festspeicher, Verwendung von Serverfestplatten<br></li><li>ECC-Arbeitsspeicher für Fehlererkennung / -korrektur<br></li><li>Unterbrechungsfreie Stromversorgung<br></li><li>Sensorüberwachung mit IPMI oder BMCs</li><li>Systeminternes Clustering (Blade-Server)</li></ul>
Wofür steht ECC und was leistet es?	Error Correcting Code - RAM-Speicher, der Ein-Bit-Fehler korrigieren und Zwei-Bit-Fehler erkennen kann
Welche Möglichkeiten gibt es für die Herstellung von Ausfallsicherheit zwischen Systemen?	<ul><li>Active / Active Clustering von ähnlichen Systemen<br></li><li>Active / Passive Standby mit Spiegelsystem<br></li><li>Doppelung von Netzwerkkomponenten<br></li><li>Virtualisierung und Containervirtualisierung für schnelle Replikation / Rollback</li></ul>
Was sind Appliance-Server / Thin Server?	Vom Hersteller fertig vorinstallierte, in ihrer Hardware auf den Verwendungszweck angepasste Server
Wofür steht RAID und wozu dient es?	Redundant Array of Independent Disks - Datensicherheit bei Ausfällen und Erhöhung der Performance, <b>kein </b>Backup!
Welche RAID-Level sind die gebräuchlichsten?	RAID 0, 1, 10, 5 und 6
In welcher Reihenfolge werden kombinierte RAID-Level bei der Nummerierung angegeben?	Von unten nach oben - RAID 10 ist ein RAID 0, bestehend aus zwei RAID 1-Verbünden
Was charakterisiert RAID 0?	Stripes befinden sich <b>abwechselnd</b> auf beiden Platten
Wie viel Ausfallsicherheit, Performance&nbsp;und Datenkapazität bietet RAID 0 bezogen auf die Zahl der Festplatten?	<ul><li>Keine Ausfallsicherheit<br></li><li>Lesen: <b>1</b> × Platten × IOPS</li><li>Schreiben: <b>1</b> × Platten × IOPS</li><li>Volle Kapazität<br></li></ul>
Wie viel Ausfallsicherheit, Performance&nbsp;und Datenkapazität bietet RAID 1 bezogen auf die Zahl der Festplatten?	<ul><li>50% Ausfallsicherheit<br></li><li>Lesen: <b>1</b> × Platten × IOPS</li><li>Schreiben: <b>0,5</b>&nbsp;× Platten × IOPS</li><li>50% Kapazität<br></li></ul>
Wie viel Ausfallsicherheit, Performance&nbsp;und Datenkapazität bietet RAID 10 bezogen auf die Zahl der Festplatten?	<ul><li>50% Ausfallsicherheit bei Ausfall von Platten der gleichen Seite der RAID-1-Spiegel<br></li><li>Lesen: <b>1</b>&nbsp;× Platten × IOPS</li><li>Schreiben: <b>0,5</b> ×&nbsp;Platten × IOPS</li><li>50% Kapazität<br></li></ul>
Wie viel Ausfallsicherheit, Performance und Datenkapazität bietet RAID 5 bezogen auf die Zahl der Festplatten?	<ul><li>Einfache Ausfallsicherheit<br></li><li>Lesen: <b>1</b> × Platten × (IOPS / Platte)</li><li>Schreiben: <b>0,25</b> × Platten × (IOPS / Platte)</li><li>Kapazität = ( Platten - 1 ) * kleinste Kapazität<br></li></ul>
Wie viel Ausfallsicherheit, Performance und Datenkapazität bietet RAID 6 bezogen auf die Zahl der Festplatten?	<ul><li>Zwei Platten Ausfallsicherheit<br></li><li>Lesen:&nbsp;<b>1</b> × Platten × IOPS</li><li>Schreiben: <b>0,17 </b>× Platten × IOPS</li><li>Kapazität = ( Platten - 2 ) * kleinste Kapazität<br></li></ul>
Was charakterisiert RAID 1?	Paralleles Schreiben der Daten auf Platten beider Seiten des Verbunds
Was charakterisiert RAID 10?	<ul><li>Ein RAID 0-Verbund bestehend aus zwei RAID 1-Verbünden<br></li><li>Kosten- und hardwareintensiv<br></li></ul>
Was charakterisiert RAID 5?	Block-Striping mit verteilten Paritätsinformationen
Was charakterisiert RAID 6?	Block-Striping mit verteilten Paritätsinformationen, bestehend aus zwei verschiedenen Prüfsummen
Wovor schützt RAID nicht?	<ul><li>Ausfall von Platten über die Kompensationsfähigkeit des Level hinaus<br></li><li>Schleichender Datenverfall (Bit Rot)<br></li><li>Gewollte oder versehentliche Löschung oder Änderung von Daten<br></li></ul>
Wogegen ist RAID besonders anfällig?	Stromversorgungsprobleme
Welche Typen von Hypervisoren gibt es?	<ul><li>Native / Typ 1: Betrieb direkt auf der Hardware<br></li><li>Hosted / Typ 2: Betrieb mit darunter liegendem Betriebssystem<br></li></ul>
Was ist ein Hypervisor?	Eine Abstraktionsschicht, die eine Trennung zwischen tatsächlicher und virtueller Hardware schafft
Wie sind SIP und VoIP abgegrenzt?	<ul><li>VoIP: Allgemeine Übertragung von Sprachdaten über IP<br></li><li>SIP: Protokoll für Initiierung, Terminierung und Umleitung von VoIP-Sitzungen<br></li></ul>
Wofür steht SIP und was leistet es?	Session Initiation Protocol:<div><ul><li>Initiierung, Terminierung und Steuerung von VoIP-Sitzungen<br></li><li>Konferenzfähigkeit<br></li><li>Datensicherheit<br></li><li>Anrufrouting<br></li></ul></div>
Wofür steht DECT und was leistet es?	Digital Enhanced Cordless Telecommunications:<br><div><ul><li>Drahtlosübertragung von Sprachdaten<br></li><li>Logische Sterntopologie mit Basisstation<br></li><li>Authentifizierung und Autorisierung von Mobilteilen<br></li><li>Verschlüsselung<br></li></ul></div>
Welche Kabelspezifikation sollte bei kupferbasierten Ethernetkabeln im Unternehmensnetz gewählt werden?	Minimal Cat 6, besser Cat 6A oder 7
Welche Dokumente entwickelt die International Engineering Taskforce (IETF)?	Die Requests for Comment (RFCs), die das Verhalten von Netzwerkdiensten standardisieren
Wofür ist die Internet Corporation for Assigned Names and Numbers (ICANN) zuständig?	Die Regulierung des welteweiten DNS-Systems, insb. der Top-Level-Domains
Was ist die ISO?	Ein Dachverband nationaler Normierungsorganisationen, der welweite Standards koordiniert
Wofür ist das Institute of Electrical and Electronic Engineers (IEEE) zuständig?	Normierung besonders von Hardware-Spezifikationen
Wofür ist die Internet Assigned Numbers Authority (IANA) zuständig?	Verwaltung von IPs und Ports
Was ist ein ASIC-Baustein?	Application Specific Integrated Circuit - ein IC, der speziell für eine sehr komplexe Aufgabe entwickelt wurde
Was beschreibt der Begriff Modulation in der Nachrichtentechnik?	<ul><li>Eine festgelegte Trägerfrequenz wird durch Aufbringung eines Nutzsignals verändert (moduliert)<br></li><li>Am Ziel wird das Nutzdatensignal aus der bekannten Trägerfrequenz errechnet (demoduliert)<br></li></ul>
Was beschreibt der Begriff Multiplexing in der Nachrichtentechnik?	<div>Bündelung von Signalen auf einer Leitung mittels verschiedener Verfahren - relevant:</div><ul><li>Synchrones Zeitmultiplexing: Signale werden mittels Taktung zeitlich versetzt übertragen<br></li><li>Aynchrones Zeitmultiplexing: Nur tatsächlich sendende Stationen haben Medienzugriff<br></li><li>Frequenzmultiplexing: Modulation von Signalen auf eigene Träger, Bündelung der entstehende schmalen Bänder auf Breitbandsignal<br></li></ul>
Was ist ein Modem?	Ein Modulator / Demodulator - ein Gerät, das Daten mit einem Dienstanbieter über ein Modulationsverfahren kommuniziert
Was bezeichnen die Begriffe Data at Rest, Data in Use, Data in Transit?	<div>Grobe Unterscheidung ohne vollständige Abgrenzung:</div><ul><li>Data at Rest: Persistent gespeicherte Daten auf Festplatten oder in Archiven<br></li><li>Data in Use: Flüchtig gespeicherte Daten in RAM oder Registern<br></li><li>Data in Transit: Sich auf dem Transportweg über ein Netzwerk befindliche Daten<br></li></ul>
Wie breit ist ein Nibble in der Binärrechnung?	4 bit
Wie breit ist ein Byte in der Binärrechnung?	8 bit
Wie breit sind Word, Dword und Quad in der Binärrechnung?	<ul><li>Variabel - Word üblicherweise 16bit, andernfalls genaue Angabe<br></li><li>Dword = Double Word, Qaud = Quadruple Word<br></li></ul>
Welche drei Sicherungskonzepte gibt es im Rahmen von Backups?	<ul><li>Vollbackup - Sicherung aller Dateien<br></li><li>Differenziell - Sicherung der Differenz zum letzten Vollbackup<br></li><li>Inkrementell - Sicherung der seit dem letzten inkrementellen Backup veränderten Daten<br></li></ul>
Was ist die Sicherung nach dem Generationenprinzip / Grandfather-Father-Son Principle?	<ul><li>Dreistufige Bandsicherung mit verschiedenen Rotationsintervallen<br></li><li>Wiederverwendung der gleichen Bänder nach Ablauf mehrerer Intervalle<br></li><li>Keine Aussage über Datenspeicherort, Intervall oder Sicherungsverfahren<br></li></ul>
Was ist der Grandfather bei der Sicherung nach dem Generationenprinzip?	"Längstes Intervall - ""Monatssicherung"", üblicherweise ein Vollbackup"
Was ist der Father bei der Sicherung nach dem Generationenprinzip?	"Mittleres Intervall - ""Wochensicherung"", üblicherweise ein differenzielles Backup"
Was ist der Son bei der Sicherung nach dem Generationenprinzip?	"Kürzestes Intervall - ""Tagesbackup"", üblicherweise ein inkrementelles Backup"
Was sind die Hauptvorteile bei der Sicherung nach dem Generationenprinzip?	<div><ul><li>Verfügbarkeit mehrerer Versionen für die Wiederherstellung<br></li><li>Wiederherstellung einer Ebene durch Kombination der beiden anderen<br></li><li>Leichte Auslagerung der Mechanismen auf andere Medien / Speicherorte<br></li></ul></div>
Was versteht man unter einem Snapshot?	<ul><li>Komplettabbild eines Speicherzustands (Festspeicher, RAM und Register) zu einem Zeitpunkt<br></li><li>Ggf. in Differenz zu einem bestimmten anderen Zustand</li><li>Insb. im Zusammenhang mit virtuellen Maschinen relevant<br></li></ul>
Wozu dient ein Snapshot?	<ul><li>Zur schnellen Wiederherstellung nach administrativen oder Nutzerfehlern<br></li><li>Zum Rollback bei Fehlern in neu installierter Software<br></li></ul>
Was sind MTBR und MTBF im Kontext von Backups?	<ul><li>Mean Time to Restore / Repair - erwartbare Zeit für eine Wiederherstellung<br></li><li>Mean Time between Failures - Erwartbare Zeit zwischen zwei Ausfällen einer Systemkomponente<br></li></ul>
Was ist ein SLA?	Service Level Agreement - eine vertraglich abgesicherte Dienstleistungserwartung gegenüber einem Hersteller
Was versteht man unter Onboarding?	<ul><li>Ersteinführung eines neuen Nutzers in das IT-System<br></li><li>Anlegen von Accounts, Definition von ACLs, Einrichten von Systemen<br></li><li>Kommunikation über und Unterzeichnen von Policies<br></li></ul>
Was versteht man unter Offboarding?	<ul><li>Entfernung eines Nutzers aus dem IT-System<br></li><li>Strukturierter Prozess zur Entziehung aller Zugriffsrechte<br></li><li>Vordefinierte Umgangsweise mit Hardware und Daten des Users<br></li><li>Deaktivierung von Accounts<br></li></ul>
Was bedeutet BYOD?	Bring Your Own Device - Nutzung privater Geräte am Arbeitsplatz
Was sind Vor- und Nachteile von BYOD?	"<div><span class=""advantage"">Kostenersparnisse</span></div><div><span class=""advantage"">Höhere Akzeptanz durch die Nutzer</span><br></div><div><span class=""disadvantage"">Klare Policies notwendig</span><br></div><div><span class=""disadvantage"">Hohes Sicherheitsrisiko</span><br></div><div><span class=""disadvantage"">Vermischung geschäftlicher und privater Daten</span><br></div>"
Was ist eine Acceptable Use Policy (AUP)?	<ul><li>Detaillierter Verhaltenskodex für die Verwendung der Unternehmens-IT<br></li><li>Hintergrund: Rechtliche Absicherung gegen Fehlverhalten der User<br></li></ul>
Was ist Change Control?	Formeller Prozess zur Beantragung, Beurteilung und Genehmigung jeglicher Konfigurationsänderungen in der Unternehmens-IT
Was bezeichnet man als Bootstrapping?	Henne-Ei-Probleme wie das Kompilieren eines Compilers oder das Laden eines Programms für den Speicherzugriff
Was sind die Hauptaufgaben des BIOS?	<ul><li>Lösung des Boostrapping-Problems beim Boot<br></li><li>Abstraktionsschicht für die Hardware - Bereitstellung von grundlegenden Treibern<br></li><li>POST - Power On Self Test, grundlegender Hardware-Check<br></li><li>Initialisierung der Hardware beim Boot<br></li><li>Treffen von Firmware-Einstellungen<br></li></ul>
Was ist ein POST?	Power On Self Test, grundlegende Hardwareprüfung durch das BIOS beim Boot
Was prüft das BIOS beim POST?	<div>Erster Teil:</div><ul><li>CPU<br></li><li>CPU-nahen Bausteinen<br></li><li>CMOS-RAM<br></li><li>CPU-Caches<br></li><li>64 kB des Arbeitsspeichers<br></li><li>Grafikkarte / Grafikspeicher<br></li></ul><div>Zweiter Teil:</div><ul><li>Gesamten Arbeitsspeicher<br></li><li>Tastatur<br></li><li>Weitere Peripheriegeräte, z. B. Speicher<br></li></ul>
Wie gibt ein BIOS Warnmeldungen aus, wenn der POST fehlschlägt?	<ul><li>Bei Fehlern im ersten Teil (vor Inbetriebnahme der Grafikkarte): Tonsignale, tlw. LED-Segmentanzeige<br></li><li>Bei Fehlern im zweiten Teil (nach Inbetriebnahme der Grafikkarte): Bildschirmausgabe<br></li></ul>
Durch welche Technik wurde das BIOS ersetzt und warum?	UEFI
Was sind die Hauptvorteile von UEFI gegenüber dem BIOS?	<ul><li>Hardwareunterstützung für breites Spektrum<br></li><li>Netzwerkunterstützung und Fernzugriff<br></li><li>Fähigkeit zum Selbstupdate<br></li><li>Neue Partitionstabelle für Medien &gt;2,2 TB<br></li><li>Modernes Interface mit komplexen Funktionen (Browser etc.)<br></li></ul>
Wo speichert das BIOS seine Einstellungen?	Complementary Metal Oxide Semiconductor RAM - flüchtiger Speicherbaustein speziell für BIOS
Welche Vor- und Nachteile hat die Speicherung der BIOS-Einstellungen im CMOS-RAM?	"<div><span class=""advantage"">Löschen durch Entfernen der Batterie</span></div><div><span class=""disadvantage"">Verlust bei Entleerung der Batterie + Stromausfall</span><br></div>"
Welche Schutzmechanismen bietet ein typisches BIOS / UEFI?	<ul><li>Nutzerpasswort für Start des OS<br></li><li>Administratorpasswort für das BIOS<br></li><li>TPM-Unterstützung für Festplattenvollverschlüsselung<br></li><li>CompuTrace / LoJack - Überwachung bei Diebstahl<br></li><li>Secure Boot - Signierung von Systemsoftware</li></ul>
Wie wird ein BIOS-Update durchgeführt?	<div><ul><li>Früher: Austausch des BIOS-ROM<br></li><li>Klassisch: Durch Start eines separaten Betriebssystems (z. B. FreeDOS) mit Updateprogramm<br></li><li>Heute: Direktes Update aus dem laufenden Betriebssystem<br></li><li>UEFI: Update direkt im UEFI<br></li></ul></div>
Was ist vor und während einem Update von BIOS oder UEFI unbedingt zu beachten?	<ul><li>Klärung, ob Update überhaupt wünschenswert ist (Risiko)<br></li><li>Absolute Sicherung der Stromzufuhr<br></li><li>Finger weg während des Updates<br></li></ul>
Welche Mainboardtypen sind heute besonders relevant?	<ul><li>ATX / Micro-ATX: Klassischer Desktop-Formfaktor<br></li><li>Mini-ITX / Nano-ITX / Pico-ITX: Formfaktor für HTPCs und mobile Geräte<br></li></ul>
Wie erfolgt die Stromzufuhr bei ATX- und ITX-Mainboards und welche Spannungen werden verwendet?	"Über einen 24+4/8-Stecker (""ATX Header""):<div><ul><li>+3,3VDC<br></li><li>±5VDC<br></li><li>±12VDC<br></li></ul></div>"
Was ist der Hauptunterschied zwischen ATX und microATX?	<ul><li>Nur die Größe - weniger Erweiterungsslots, komprimiertes Layout<br></li><li>Kompatibel zu ATX beim Einbau<br></li></ul>
Was ist der Hauptunterschied der ITX- zur ATX-Spezifikation für Motherboards?	<ul><li>Spezifiziert für niedrigen Stromverbrauch und kleineren Formfaktor für mobile Geräte<br></li><li>Kompatibel zu ATX beim Einbau<br></li></ul>
Wofür steht RAM und warum?	Random Access Memory - kein Read Only Memory (ROM), nicht sequentieller Speicherzugriff
Wofür steht ROM und welche Untertypen gibt es?	Read Only Memory:<div><ul><li>ROM - einmal gebrannt<br></li><li>Programmable ROM - einmal programmatisch gebrannt<br></li><li>Erasable PROM - löschbar mit UV-Licht etc.<br></li><li>Electrically EPROM - löschbar mit elektrischem Signal<br></li></ul></div>
Welche Formfaktoren für RAM gibt es?	<ul><li>Dual Inline Memory Module (DIMM) - Desktop-Formfaktor<br></li><li>Small Outline DIMM (SO-DIMM) - Laptop-Formfaktor, 68mm<br></li><li>MicroDIMM - Für mobile Geräte, 54mm<br></li></ul>
Für was ist die Southbridge einer klassischen Mainboard-Architektur zuständig?	I/O-Verwaltung:<div><ul><li>Peripherie<br></li><li>Festspeicher<br></li><li>Erweiterungskarten<br></li><li>Netzwerk<br></li><li>etc.<br></li></ul></div>
Für was ist die Northbridge einer klassischen Mainboard-Architektur zuständig?	<ul><li>Zentraler Speichercontroller für den RAM<br></li><li>Grafikkarte<br></li></ul>
Welche Komponenten hat eine klassische Mainboard-Architektur?	<ul><li>CPU<br></li><li>Nortbridge<br></li><li>Southbridge<br></li><li>Speichersteckplätze<br></li><li>Grafikkarte<br></li><li>Erweiterungssteckplätze<br></li><li>Onboard-Speicher (CMOS RAM etc.)<br></li><li>Super I/O (Serielle &amp; parallele Schnittstelle, Tastatur, Maus etc)<br></li></ul>
Welche Typen gibt es im Systembus bei der klassischen Mainboard-Architektur?	<ul><li>Adressbus - gibt eine Adresse im Speicher an<br></li><li>Datenbus - überträgt die Daten selbst<br></li><li>Steuerbus - löst eine Aktion aus oder überträgt Interrupts<br></li></ul>
Wie läuft ein Lesen aus dem RAM in einer klassischen Systembus-Mainboardarchitektur ab?	<ul><li>RAM-Adresse wird an Adressbus angelegt<br></li><li>READ wird am Steuerbus angelegt<br></li><li>Speicherzelle legt Inhalt am Datenbus an<br></li><li>CPU liest den Datenbus aus<br></li></ul>
Was löste die Systembus-Architektur ab und wie wurde die neue Architektur genannt?	Front Side Bus: Bus von CPU zum Chipset, dort weitere Aufteilung
Wodurch wurde die klassiche Mainboard-Architektur mit CPU, Northbridge und Southbridge abgelöst und warum?	Integration der Northbridge in die CPU zur Erhöhung der Durchsatzrate
Was charakterisiert einen parallelen Bus?	<ul><li>Gleichzeitige Übertragung einer festgelegten Zahl von Bit</li><li>Eine Datenleitung je Bit Breite<br></li><li>Über Steuerleitung wird eine Aktion ausgelöst</li></ul>
Was charakterisiert einen seriellen Bus?	<ul><li>Sequentielle Übertragung der Bits<br></li><li>Einzelne Datenleitung für Übertragung in eine Richtung</li><li>Optionale separate Taktleitung</li></ul>
In welchen Zusammenhängen werden die SI-Einheiten kbit, Mbit, Gbit und die binären Einheiten kiB, MiB, GiB nach Konvention korrekt verwendet?	<ul><li>SI-Einheiten: Datenraten bei Übertragungen<br></li><li>Binäre Einheiten: Speicherung von Daten<br></li></ul>
Wie viele physische Traces hat ein PCIe-Anschluss?	<ul><li>PCIe ist seriell und Full Duplex mit Referenztakt - eine Leitung je Richtung je Lane<br></li><li>x8 z. B. 16 Traces<br></li></ul>
Was ist ein Multiplikator bei einer Mainboardarchitektur mit Front Side Bus (FSB)?	Einstellung des Vielfachen oder Bruchteils der FSB-Taktung, mit der eine Komponente betrieben wird - Beispiel:<br><ul><li>FSB mit 100 MHz</li><li>CPU-Multiplikator 12 ⇒ CPU mit 12 MHz Taktung<br></li><li>AGP-Multiplikator 2/3 ⇒ AGP mit 66 MHz Taktung</li></ul>
Was ist PCI-X?	<ul><li>Weiterentwicklung von PCI mit parallelem Bus<br></li><li>Höhere Datenraten und Taktung<br></li><li>Nicht mehr relevant und nicht zu werwechseln mit PCIe<br></li></ul>
Welcher Standard für Erweiterungskarten wird bei mobilen Geräten üblicherweise verwendet?	Mini PCI / PCI Express Mini
Was ist schneller: serielle und parallele Datenübertragung? Warum?	Seriell - keine Synchronisation der verschiedenen Leitungen notwendig
Was ist ein ZIF Socket auf einem Motherboard?	Zero Insertion Force - ein CPU-Socket mit Hebel, um das Einsetzen der CPU sicherer zu gestalten
Welche Ausführungen von CPU-Sockets gibt es?	<ul><li>Low Insertion Force (LIF) - manuelles Einpressen<br></li><li>Zero Insertion Force (ZIF) - Einsetzen mit Hebel<br></li><li>Land Grid Array (LGA) - Pins im Socket statt an der CPU<br></li><li>Slot - Steckkartenplatz für Prozessoren<br></li><li>Ball Grid Array (BGA) - Lötpunkt-Raster zum festen Einlöten<br></li></ul>
Was ist SRAM?	Static RAM<div><ul><li>Nichtflüchtiger, extrem schneller RAM<br></li><li>Große Abmessungen, hoher Preis<br></li><li>Einsatz insb. für Caches<br></li></ul><div>Nicht zu verwechseln mit SDRAM!</div></div>
Was ist DRAM und warum wurde er so benannt?	Dynamic Random Access Memory:<div><ul><li>Flüchtiger Speicher, der ständig neu beschrieben werden muss<br></li><li>Wahlfreier statt sequentieller Speicherzugriff<br></li></ul></div>
Welche Speichertypen für Arbeitsspeicher entstanden in welcher Reihenfolge?	<ul><li>DRAM - Dynamischer RAM allgemein<br></li><li>SDRAM - Synchronous DRAM mit Taktung über Systemtakt<br></li><li>DDRAM - Double Data Rate RAM, zwei Symbole pro Takt<br></li><li>DDRAM2 und DDRAM3 - 4x und 8x Prefetch<br></li><li>DDRAM4 - Höhere Taktung und geringere Spannung<br></li><li>DDRAM5 - geplant für 2020<br></li></ul>
Was ist der Prefetch im Kontext von RAM?	Speichervorgriff:<div><ul><li>Einzelner Lesebefehl führt zu doppeltem (DDRAM), vierfachem (DDRAM2) oder achtfachem (DDRAM3/4) Vorgriff auf den Speicher<br></li><li>Beschleunigt insb. sequentielles Lesen<br></li></ul></div>
"Wie kommt eine Angabe wie ""DDR3-1866 (PC3-14900)"" zustande und was gibt sie an?"	<ul><li>DDR3 / PC3: DDRAM3-Modul<br></li><li>1866: Datenrate in MT/s<br></li><li>14900: 14,9 GBps Übertragungsrate je Modul (Prefetch * Speichertakt * Busbreite) / 8<br></li></ul>
Welche Busbreite für Daten- und Adressbus haben DDR-RAM-Module?	<ul><li>Datenbus: 64bit<br></li><li>Adressbus: 32bit - es wird innerhalb des Bausteins adressiert! (8x4 GByte)<br></li></ul>
Was ist Parity Memory?	Server-RAM mit einfacher Fehlererkennung, aber ohne Fehlerkorrektur
Was ist eine Parität?	<ul><li>Umgangsprachliche Kurzform für ein Zusatzbit, das eine ungerade Zahl von Einsen gerade macht (Even Parity) oder umgekehrt (Odd Parity)<br></li><li>Relevant in vielen Formen von Bitfehlererkennung<br></li></ul>
Was ist Registered Memory?	<ul><li>Speicher mit Registerchips zwischen Speicher und Speichercontroller</li><li>Reduziert elektrische Belastung des Speichercontrollers</li><li>Aufbereitung des Taktsignals</li></ul>
Was ist Dual Channel Memory?	Der Einsatz zweier Speichermodule in zusammengehörigen Bänken zur Erzeugung eines 2x64=128bit breiten Datenbusses
Was ist Single bzw. Double Sided Memory?	<ul><li>Umgangssprachlich: Physische Anbringung der Bausteine auf dem Modul<br></li><li>Technisch: Synonym für den Rank (Side), unabhängige Bausteingruppen<br></li></ul>
Was beschreibt die Zahl der Ranks eines RAM-Moduls?	<ul><li>Zahl der separat adressierbaren Gruppen von Speicherbausteinen<br></li><li>Verhalten wie separate RAM-Module</li><li>Nur ein Rank kann gleichzeitig verwendet werden<br></li><li>Niedrigere Rank-Zahl - mehr Performance, höhere Rank-Zahl - mehr Speicher</li></ul>
Auf welcher Speichertechnik basieren SSDs?	NAND Flash Memory
Welche Typen von Flash-Speicher kommen derzeit in SSDs zum Einsatz?	<ul><li>Single Level Cell (SLC) - ein Bit (Zustand) pro Speicherzelle<br></li><li>Multi Level Cell (MLC) - zwei Bit pro Speicherzelle<br></li><li>Triple Level Cell (TLC) - drei Bit pro Speicherzelle<br></li><li>Quad Level Cell (QLC) - vier Bit pro Speicherzelle<br></li></ul>
Welches ist der schnellste und zuverlässigste kommerziell verfügbare SSD-Speichertyp?	SLC NAND Flash
Auf welcher Speichertechnik basieren herkömmliche Festplatten?	Magnetische Speicherung auf metallischen oder metallbedampften Glasplatten
Welche Größenordnung der Latenz ist bei einer HDD mit 10k, 7k2 und 5k4 RPM jeweils zu erwarten?	<ul><li>10k: 3ms<br></li><li>7k2: 4ms<br></li><li>5k4: 5,5ms<br></li></ul>
Aus welchen Hauptkomponenten besteht eine herkömmliche Festplatte?	<ul><li>Speicherplatten<br></li><li>Spindel als Lager<br></li><li>Schreib-Lese-Arm für Zugriff auf Platten<br></li><li>Aktuator für die Bewegung des Arms<br></li></ul>
Was bezeichnet man als Hybridlaufwerk?	Kombination aus HDD und SSD - SSD als Cache für die HDD
Was sind Vor- und Nachteile der Verwendung von SSDs gegenüber HDDs?	"<div><span class=""advantage"">Vielfache Geschwindigkeit</span></div><div><span class=""advantage"">Wahlfreier Datenzugriff</span><br></div><div><span class=""advantage"">Höhere Lebensdauer</span><br></div><div><span class=""advantage"">Geringerer Stromverbrauch</span></div><div><span class=""advantage"">Mechanisch und magnetisch unempfindlich</span><br></div><div><span class=""disadvantage"">Höherer Preis</span><br></div><div><span class=""disadvantage"">Geringere Kapazität</span><br></div>"
Was ist ein Hot Spare Drive und warum wird es verwendet?	<ul><li>Zusatzfesplatte im RAID, die im Fehlerfall sofort den Wiederaufbau beginnt<br></li><li>Verringert Mean Time to Recovery (MTTR) und damit Wahrscheinlichkeit weiterer Ausfälle<br></li></ul>
Was sind derzeit die wichtigsten Standards für den Anschluss von Festplatten?	<ul><li>SATA<br></li><li>SCSI<br></li><li>SAS<br></li><li>M.2</li></ul>
Wofür steht SCSI und was ist charakteristisch für den Standard?	Small Computer System Interface:<div><ul><li>Ältester derzeit noch verwendeter Standard<br></li><li>Parallele Datenübertragung<br></li><li>Nicht hotplugfähig<br></li><li>Allgemeine Anbindung von Peripheriegeräten</li><li>Netzwerkfähig mit iSCSI</li><li>Raten bis 2,6 Gbps (Ultra-320)<br></li><li>Weiterentwickelt zu Serial Attaches SCSI (SAS)<br></li></ul></div>
Wofür steht SATA und was ist charakteristisch für den Standard?	Serial Attached ATA:<div><ul><li>Häufigstes und modernstes Interface für Standardanwendungen<br></li><li>Serielle Datenübertragung<br></li><li>Hotplugfähig<br></li><li>Externe Speicher mit eSATA<br></li><li>Raten bis 16 Gbps Half Duplex (SATA3.2)<br></li><li>Consumer-Technik</li></ul></div>
Wofür steht SAS und was ist charakteristisch für den Standard?	Serial Attached SCSI:<div><ul><li>Schnellster derzeit verwendeter Standard<br></li><li>Serielle Datenübertragung<br></li><li>Theoretisch hotplugfähig<br></li><li>Bis zu 22,5 Gbps Full Duplex (SAS-4)<br></li><li>Server-Technik<br></li></ul></div>
Was sind die Vor- und Nachteile von Flash-Speicher?	"<div><span class=""advantage"">Nichtflüchtiger Speicher</span></div><div><span class=""advantage"">Kein permanenter Stromverbrauch</span><br></div><div><span class=""disadvantage"">Zugriff nur blockweise</span><br></div><div><span class=""disadvantage"">Langsamer als ROM</span><br></div><div><span class=""disadvantage"">Begrenzte Lebensdauer einer Speicherzelle</span><br></div>"
Was sind die beiden gängigen Flash-Speicher-Architekturen und ihr Hauptunterscheidungsmerkmal?	<ul><li>NAND-Flash: Reihenschaltung, blockweises Lesen und Schreiben<br></li><li>NOR-Flash: Parallelschaltung, blockweise Adressierung und höhere Geschwindigkeit<br></li></ul>
Wofür steht LTO?	Linear Tape Open - Spezifikation für Magnetbänder und Bandlaufwerke
Welche LTO-Standards gibt es bei Magnetbändern?	LTO1-8 sind derzeit in Verwendung (bis 30 TB), beschrieben bis LTO-12 (480 TB)
Wofür kommen Magnetbänder heute üblicherweise zum Einsatz?	Backups
Welche Backup-Kapazitäten können mit derzeit gebräuchlichen Magnetbändern unkomprimiert und komprimiert umgesetzt werden?	LTO-6: 2,5 TB / 6,25 TB<div>LTO-7: 6 TB / 15 TB</div><div>LTO-7 M8: 9 TB / 22,5 TB</div><div>LTO8: 12 TB / 30 TB</div>
Was sind die Vor- und Nachteile der Verwendung von Magnetbändern für Backups?	"<div><span class=""advantage"">Kostengünstige Medien</span></div><div><span class=""advantage"">Langlebig</span><br></div><div><span class=""advantage"">Einfache Lagerung und Versand</span><br></div><div><span class=""advantage"">Hohe Kapazität</span><br></div><div><span class=""disadvantage"">Empfindlich</span><br></div><div><span class=""disadvantage"">Verschleiß</span><br></div><div><span class=""disadvantage"">Sequentieller Zugriff</span><br></div><div><span class=""disadvantage"">Teure Laufwerke</span><br></div>"
Was unterscheidet Software- und Hardwarebasiertes RAID?	<ul><li>Software-RAID: Mit Funktionen des Betriebssystems, niedrige Performance<br></li><li>Hardware-RAID: Separater Controller, unsichtbar für das OS, hohe Performance<br></li></ul>
Welche Penalties haben die RAID-Level 0, 1, 5 und 6 für Lese- und Schreiboperationen?	Lesen: Alle 1 - kein Performanceverlust!<div>Schreiben:</div><div><ul><li>RAID 0: 1<br></li><li>RAID 1: 2<br></li><li>RAID 10: 2<br></li><li>RAID 5: 4<br></li><li>RAID 6: 6<br></li></ul></div>
Was bezeichnet man im Zusammenhang mit RAID als Penalty?	"Der Faktor, um den eine Operation verlangsamt wird<div><img class=latex alt=""&#x24;Speed&#x20;&#x3D;&#x20;Penalty&#x20;&#x5C;times&#x20;Disks&#x20;&#x5C;times&#x20;&#x28;&#x5C;frac&#x7B;IOPS&#x7D;&#x7B;Disk&#x7D;&#x29;&#x24;"" src=""latex-fb938f7e31bf0b87bf6fc9d8ea8ad7a49dc0beb9.png""></div>"
Wie wird die Gesamtperformance eines RAID-Arrays berechnet?	"<img class=latex alt=""&#x24;RIOPS&#x20;&#x3D;&#x20;Disks&#x20;&#x5C;times&#x20;IOPS&#x20;&#x5C;times&#x20;ReadPct&#x20;&#x5C;&#x5C;&#x0A;WIOPS&#x20;&#x3D;&#x20;&#x5C;frac&#x7B;1&#x7D;&#x7B;Penalty&#x7D;&#x20;&#x5C;times&#x20;Disks&#x20;&#x5C;times&#x20;IOPS&#x20;&#x5C;times&#x20;WritePct&#x20;&#x5C;&#x5C;&#x20;IOPS&#x20;&#x3D;&#x20;RIOPS&#x20;&#x2B;&#x20;WIOPS&#x24;"" src=""latex-3c94d05139db33c5e913be60cd0f126759fba6e2.png"">"
Was ist ein CPU-Cache?	<ul><li>Zwischenspeicher der CPU<br></li><li>L1-L3 üblich<br></li><li>Größer und langsamer mit steigender Zahl<br></li></ul>
Was ist charakteristisch für den L1-Cache einer CPU?	<ul><li>Immer direkt auf dem Die<br></li><li>Größe bis 256 KiB<br></li><li>Separater Daten- und Befehlscache<br></li><li>Optimierung auf geringste Latenz und Maximierung der Hit Rate<br></li></ul>
Was ist charakteristisch für den L2-Cache einer CPU?	<ul><li>Meistens direkt auf dem Die<br></li><li>Größe bis 1024 KiB<br></li><li>Daten und Befehle gemeinsam gespeichert<br></li><li>Optimierung auf minimale Hit Penalty bei Fehlen der Information im L1 Cache<br></li></ul>
Was ist charakteristisch für den L3-Cache einer CPU?	<ul><li>Häufig geteilt zwischen allen Kernen<br></li><li>Größe bis 32 MiB<br></li><li>Daten und Befehle gemeinsam<br></li><li>Optimierung auf Austausch zwischen den Kernen<br></li></ul>
Was bezeichnet man als Hyperthreading (HTT)?	Virtuelle Aufteilung einer CPU in zwei zur besseren Auslastund der Pipeline mit unabhängigen Prozessen
Welche Zusatzfunktionen sind bei modernen CPUs im virtuellen Arbeitsumfeld von besonderer Bedeutung?	<ul><li>VT-x / AMD-V: Virtualisierungsunterstützung<br></li><li>EPT / RVI: Speicherverwaltungs-Virtualisierung<br></li><li>VT-d / AMD-Vi: Direkter Speicherzugriff<br></li><li>AES-NI: Hardwareunterstützung für AES<br></li></ul>
Was ist die MMU?	Memory Managment Unit:<div><ul><li>Speicherzugriffsverwaltung des Prozessors<br></li><li>Übersetzung zwischen virtuellem und physischem Speicher</li><li>Früher der Northbridge zugeordnet, heute auf dem Die</li></ul></div>
Was ist virtueller Speicher?	<ul><li>Scheinbar zusammenhängender Speicher, der einem Prozess zur Verfügung gestellt wird<br></li><li>Tatsächlich aufgeteilt in Pages, die beliebig im physischen Speicher liegen<br></li><li>MMU stellt Zuordnung zwischen virtuellem und physischem Speicher her<br></li></ul>
Was ist die Page Size im Zusammenhang der Speicherverwaltung eines Computers?	Blockgröße des virtuellen Speichers, der von der MMU auf eine Page des physischen Speichers gemappt wird
Was ist der Page Table einer MMU?	Die Zuordnung zwischen virtuellem und physischem Speicher im RAM oder im Pagefile / Swap
Welches sind übliche Werte für die Page Size im virtuellen Speicher und was beeinflusst der Wert?	<div><ul><li>4 kiB Standardgröße<br></li><li>Große Page Size verbraucht mehr Speicher (vgl. Block Size eines Dateisystems)<br></li><li>Kleine Page Size erhöht die Größe des Page Table und führt zu Overhead<br></li></ul></div>
Was ist die AFR im Kontext der Speichertechnik?	Annualized Failure Rate - prozentuale Wahrscheinlichkeit des Ausfalls einer Platte während eines Jahres
Wie identifiziert man ECC-Speicher beim Blick auf das Modul?	Zusätzlicher Paritätsspeicherbaustein für 8 tatsächliche Speicher
Was sind die Vor- und Nachteile von ECC-Speicher?	"<div><span class=""advantage"">Erkennung von 2-bit-Fehlern</span></div><div><span class=""advantage"">Korrektur von 1-bit-Fehlern</span><br></div><div><span class=""advantage"">Geringere Ausfallwahrscheinlichkeit</span><br></div><div><span class=""advantage"">Weniger schwerwiegende Ausfälle (kein POST)</span><br></div><div><span class=""disadvantage"">Muss von Mainboard unterstützt werden</span><br></div><div><span class=""disadvantage"">Höherer Preis</span><br></div><div><span class=""disadvantage"">Leichter Geschwindigkeitsverlust</span><br></div>"
Was sind die Vor- und Nachteile von Registered RAM?	"<div><span class=""advantage"">Entlastung und Stabilisierung des Speichercontrollers</span></div><div><div><span class=""disadvantage"">Muss von Mainboard unterstützt werden</span></div><div><span class=""disadvantage"">Höherer Preis</span><br></div><div><span class=""disadvantage"">Latenz erhöht um einen Taktzyklus</span><br></div><div><span class=""disadvantage"">Höherer Stromverbrauch</span><br></div></div>"
"Wie berechnet sich die Peak Transfer Rate eines Speichermoduls aus einer Angabe wie ""Dual Channel DDR4-2400""?"	"<ul><li>Datenrate D: 2400 MT/s<br></li><li>Datenbusbreite B: 64 Bit<br></li><li>Kanäle K: 2<br></li><li>Bit pro Byte: 8<br></li></ul><div><img class=latex alt=""&#x24;R&#x20;&#x3D;&#x20;&#x5C;frac&#x7B;D&#x20;&#x5C;times&#x20;B&#x20;&#x5C;times&#x20;K&#x7D;&#x7B;8&#x7D;&#x24;"" src=""latex-5527227d5ab9ca22cbfea63b84cf4ade40a15c01.png""></div>"
Welche Transferraten unterstützen aktuelle SATA-Standards?	<ul><li>SATA 3: 6 Gbps roh / 0,6 GBps netto<br></li><li>SATA Express, PCIe 3.x: 8 Gbps roh / 0,985 GBps netto<br></li><li>SATA Express, PCIe 4.0: 16 Gbps roh / 1,969 GBps netto<br></li></ul><div>SATA Express hat keine praktische Bedeutung und wurde durch M.2 + NVMe ersetzt.</div>
Was ist die Hauptverbesserung in SATA Express gegenüber herkömmlichem SATA 3.0?	PCIe-Signale zur Übertragung - geringerer Overhead
Was ist M.2?	<ul><li>Formfaktor-Spezifikation für Festspeicher-Anschluss<br></li><li>Ablöser von mSATA<br></li><li>Integriert PCIe 4x, SATA 6 Gb/s und USB3.0<br></li></ul>
Was ist NVMe?	Non-Volatile Memory Express:<div><ul><li>Protokoll für Anbindung von nichtflüchtigem Speicher</li><li>Hauptsächlich verwendet über M.2 an PCIe</li><li>Speizifikation anderer Medien möglich</li><li>Ersetzt AHCI</li></ul></div>
Was ist AHCI?	Advanced Host Controller Interface:<div><ul><li>Protokoll für Ansteuerung von SATA-Geräten<br></li><li>Macht separate SATA-Treiber unnötig<br></li><li>Wird derzeit durch NVMe ersetzt<br></li></ul></div>
Was ist die TDP eines Chips?	<ul><li>Die maximale Wärmeabgabe in Watt<br></li><li><b>Nicht </b>der Stromverbrauch, aber dazu korreliert<br></li></ul>
Was ist USB OTG?	USB On the Go: integrierter Host-Controller fuer Anschluss von USB-Peripheriegeräten
Was ist die Integrität von Daten?	Korrekter Inhalt<div>Unmodifizierter Zustand</div><div><div>Erkennung von Modifikation</div></div>
Was ist ein JBOD in der Speichertechnik?	Just a Bunch of Disks - einfache Verkettung von Festplatten zu einem Volume ohne Striping
Was sind die Vorteile eines JBOD gegenüber einem RAID?	<ul><li>Günstigere Hardware<br></li><li>Beliebige Platten verkettbar<br></li><li>Keine Bindung an geringste Plattengröße</li><li>Bessere Skalierbarkeit ohne Rebuilds<br></li><li>Geringere Gefahr eines Datenverlusts als bei RAID 0<br></li></ul>
Was ist S.M.A.R.T in der Speichertechnik?	Self-Monitoring, Analysis and Reporting Technology:<div><ul><li>Selbstüberwachung von Festplatten<br></li><li>Sensorauswertung zur Einschätzung der Zuverlässigkeit<br></li><li>Ermittlung u. a. von Leistung, Betriebsdauer, Fehlerraten<br></li></ul></div>
Welche Werte beihaltet eine Angabe wie 15-16-16-35 bei einem RAM-Modul?	<ul><li>CL: 15 Zyklen Latenz nach Adressierung einer Spalte<br></li><li>T<sub>RCD</sub>: 16 Zyklen Latenz nach Adressierung einer Zeile<br></li><li>T<sub>RP</sub>: 16 Zyklen Latenz für Zugriff auf nächste Zelle<br></li><li>T<sub>RAS</sub>: 35 Zyklen Zugriffslatenz (CL + T<sub>RCD</sub>)<br></li></ul>
Was ist die CL eines RAM-Moduls?	Column Access Latency - wichtigster Timing-Kennwert, Zahl der Latenzzyklen bei der Adressierung einer Spalte
Wie sind Unicode und UTF-8 / UTF-16 voneinander abgegrenzt?	<ul><li>Unicode: Zeichensatz der meisten weltweit verwendeten Symbole mit verschiedenen Gruppen<br></li><li>UTF-8 / UTF-16: Standard zur Binärkodierung von Unicode<br></li></ul>
Was ist die BMP im Kontext von Unicode?	Basic Multilingual Plane - Satz der am häufigsten verwendeten Unicode-Zeichen, in UTF-8 mit 3 Byte darstellbar
Welche Gruppen von Zeichen kann UTF-8 mit 1-4 Byte abbilden?	<ul><li>1 Byte: ASCII<br></li><li>2 Byte: Arabisch, Hebräisch, europäische Skripte<br></li><li>3 Byte: Basic Multilingual Plane (BMP) von Unicode<br></li><li>4 Byte: Alle Unicode-Zeichen<br></li></ul>
Welche Gruppen von Zeichen kann UTF-16 mit 2 oder 4 Byte abbilden?	<ul><li>2 Byte: Basic Multilingual Plane (BMP) von Unicode<br></li><li>4 Byte: Alle Unicode-Zeichen<br></li></ul><div>Eine granularere Aufteilung wie bei UTF-8 gibt es nicht.</div>
Was bezeichnet man in der Speichertechnik als Hierarchical Storage Managment (HSM)?	<ul><li>Speichern der Daten in verschiedenen Speichern je nach Alter und Zugriffsgeschwindigkeit<br></li><li>Laden von Daten auf eine höhere Hierarchiestufe beim Zugriff<br></li></ul>
Welche Kriterien werden beim Hierarchical Storage Managment für die Einteilung der Speicher üblicherweise verwendet?	<ul><li>Preis<br></li><li>Größe<br></li><li>Zugriffsgeschwindigkeit<br></li><li>Funktion</li></ul>
Welche Level definiert ein üblicher Tiered Storage im Kontext von Hierarchical Storage Managment?	Tier 0: Flash-Speicher - Sehr schnell, sehr klein, sehr teuer, stark veränderliche und wichtige Daten<div>Tier 1 (Primary): RAID - Schnell, groß, teuer, wichtige Daten</div><div>Tier 2 (Secondary): SAN - Langsam, groß, preiswert, Massendaten</div><div>Tier 3 (Tertiary): Tape - Sehr langsam, sehr groß, sehr preiswert, Archiv</div>
Was ist MIME?	Multipurpose Internet Mail Extensions:<div><ul><li>Standardisierte Beschreibung des Datenformats einer E-Mail<br></li><li>Kompatibilität für Sonderzeichen und Anhangsdaten<br></li><li>Definiert Content Type und Transfer Encoding<br></li><li>Content Type auch allgemein für z. B. HTTP oder Betriebssysteme zur Dateitypenerkennung<br></li></ul></div>
